flag	nick_name	flavor_name	flavor_text
$EN_SLUGWORM	RAPIDE	Ver	Engeance Rapide de Revenant|Ces sortes de vers très rapides sont dotés de plusieurs rangées de crocs acérés.<N><N>De nombreux témoins prétendent les avoir vu surgir du corps de gros Revenants bouffis, après des semaines de putréfaction.	
$EN_NORMAL_NOMONEY	<RE>$EN_NORMAL_NICK_NAME	<RE>$EN_NORMAL_FLAVOR_NAME	<RE>$EN_NORMAL_FLAVOR_TEXT	
$EN_NORMAL	NORMAL	Revenant	Cadavre réanimé|Dans la Fosse, les cadavres se relèvent souvent plusieurs jours après leur mort.<N><N>Ces monstres sont appelés des <LQ>Revenants<RQ>.	
$EN_CULTIST	PRÉDICATEUR	Prédicateur	Sanguinaire Transmuté|<RE>[$EN_CULTIST_BASIC_FLAVOR_TEXT]	
$EN_ARMORED CULTIST	PRÊTRE	Prêtre	Prêtre Sanguinaire|<RE>[$EN_CULTIST_SECT_FLAVOR_TEXT]<N><N>Les actes de violences rituelles sont accompli par les Prêtres Sanguinaires, et ces derniers exhibent souvent des marques d'auto-mutilations poussées.<N><N><RE>[$EN_CULTIST_ACCOUNT_FLAVOR_TEXT]	
$EN_INSANE CULTIST	PRÉDICATEUR FOU	Grand Prêtre	Grand Prêtre Sanguinaire|<RE>[$EN_CULTIST_SECT_FLAVOR_TEXT] <N><N>Certains récits historiques quaidiens affirment que ce culte était autrefois dirigé par un organe matriarcal appelé <LQ>La Reine aux Nombreux Diables<RQ>. Cette structure centrale semble avoir disparu au cours des derniers siècles en faveur une assemblée plus informelle de hauts-prêtres.	
$EN_NORMAL_EXP	<RE>$EN_NORMAL_NICK_NAME	<RE>$EN_NORMAL_FLAVOR_NAME	<RE>$EN_NORMAL_FLAVOR_TEXT	
$EN_NORMAL_EXP_PSI	<RE>$EN_NORMAL_NICK_NAME	<RE>$EN_NORMAL_FLAVOR_NAME	<RE>$EN_NORMAL_FLAVOR_TEXT	
$EN_NORMAL_W	<RE>$EN_NORMAL_NICK_NAME	Mal Aquatique	Revenant Aquatique|Ces Revenants exsudent une substance poisseuse qui rend leur corps imperméable.<N><N>Leur abdomen est rempli de gaz toxique, ce qui leur évite de couler.	
$EN_ARMORED	CUIRASSÉ	Chevalier Déchu	Revenant Cuirassé|Ces Revenants sont d'anciens Chevaliers ayant péri au combat.<N><N>Bien qu'ils n'aient rien conservé de l'intelligence et des compétences dont ils bénéficiaient de leur vivant, ils ont toujours leur armure.	
$EN_SPEEDY	RAPIDE	Ver	Engeance Rapide de Revenant|Ces sortes de vers très rapides sont dotés de plusieurs rangées de crocs acérés.<N><N>De nombreux témoins prétendent les avoir vus surgir du corps de gros Revenants enflés, après des semaines de putréfaction.	
$EN_SPEEDY_W	<RE>$EN_SPEEDY_NICK_NAME	Serpent	Engeance Rapide Aquatique|On raconte que ces vers aquatiques seraient issus de corps de Revenants laissés à la dérive.<N><N>D'autres suggèrent qu'ils proviendraient des cadavres des poissons et des serpents des rivières.	
$EN_ARMORED SPEEDY	<RE>$EN_SPEEDY_NICK_NAME	Ver Cuirassé	Engeance Rapide Cuirassée|Ces vers ont développé une épaisse carapace.<N><N>Une théorie voudrait que cette cuirasse soit composée des os digérés du cadavre originel.	
$EN_ARMORED_SPEEDY_W	<RE>$EN_SPEEDY_NICK_NAME	Serpent Cuirassé	Engeance Rapide Cuirassée Aquatique|Ces vers aquatiques ont à la fois développé une capacité à nager et une épaisse carapace.<N>Leur odeur d'os digérés et de gaz de décomposition est particulièrement écœurante.	
$EN_ATTACKER	COMBATTANT	Goule Folle	Revenant Combattant|Certains Revenants sont plus agressifs que les autres.<N><N>Alors que les Revenants standards s'obstinent à traquer une unique victime, ceux-ci s'en prennent véritablement à tout ce qui bouge.	
$EN_DARK ATTACKER	CAMOUFLEUR	Goule Noire	Revenant Combattant Noir|Les gaz qui s'accumulent dans l'abdomen de ce Revenant s'échappent par les pores de sa peau, ce qui enveloppe la créature dans un épais nuage de fumée toxique qui le dissimule, tout en plongeant ses ennemis dans la confusion.	
$EN_ATTACKER_W	<RE>$EN_ATTACKER_NICK_NAME	Goule des Rivières	Revenant Combattant Aquatique|Les récits de cadavres puants surgissant des eaux pour attaquer les villageois assoiffés abondent dans la Fosse.<N><N>Personne ne part jamais chercher de l'eau tout seul, et seuls les fous s'aventurent à piquer une tête...	
$EN_ARMORED ATTACKER	<RE>$EN_ATTACKER_NICK_NAME	Chevalier Fou	Revenant Combattant Cuirassé|Ces Chevaliers déchus sont aussi forts que vicieux.<N><N>Leurs hurlements inhumains résonnent à travers les catacombes et vont se perdre dans le désert.	
$EN_RAPID_ATTACKER	ATTAQUE RAPIDE	
$EN_APC	DIVISEUR	Monstruosité	Hôte d'Engeance|Ces cadavres bouffis peuvent à peine se déplacer et semblent prêts à éclater à tout instant.<N><N>Plusieurs bouches garnies de crocs émergent de leurs flancs. Ils sont également trop gros pour être repoussés ou dévorés.			
$EN_APC_W	<RE>$EN_APC_NICK_NAME	Cadavre Fétide	Hôte d'Engeance Aquatique|Ces Revenants puent comme un sac de poisson pourri qui aurait mariné dans des eaux d'égout...<N><N>Ils flottent facilement et semblent prêts à éclater à tout instant.	
$EN_ARMORED APC	DIVISEUR CUIRASSÉ	Bête Cuirassée	Hôte d'Engeance Cuirassé|Une carapace géante protège cette monstrueuse masse de chair digérée.<N><N>On la soupçonne d'être totalement dépourvue d'os.	
$EN_DOUBLE APC	DOUBLE DIVISEUR	Abomination	Hôte d'Engeance Diviseur|Ce monstre étrange est à la fois décoloré et bouffi.<N><N>Que cela peut-il signifier ?	
$EN_ARMORED RANGED ATTACKER	<RE>$EN_RANGED ATTACKER_NICK_NAME	Goule Vipère	Revenant Cracheur Cuirassé|<RE>[$EN_RANGED ATTACKER_FLAVOR_TEXT]	
$EN_RANGED ATTACKER	À DISTANCE	Goule Vipère	Revenant Cracheur|<RE>[$EN_RANGED ATTACKER_BASIC_FLAVOR_TEXT]	
$EN_RANGED ATTACKER_W	<RE>$EN_RANGED ATTACKER_NICK_NAME	Goule Vipère des Rivières	Revenant Cracheur Aquatique|<RE>[$EN_RANGED ATTACKER_BASIC_FLAVOR_TEXT]	
$EN_DARK	OBSCUR	Ver des Ombres	Engeance Noire Rapide|Ces vers sont enveloppés dans une épaisse brume noire qui les rend quasiment impossibles à toucher.
$EN_BRUTE	CORIACE	Ver de la Mort	Engeance Coriace de Revenant|Ces créatures pâles apparentées à des vers se déplacent lentement, et sont dotées d'une peau cuireuse robuste à la place de l'habituelle membrane extérieure fragile.<N><N>Bien que faciles à distancer, elles triomphent en général de leurs proies en les poursuivant sans relâche, jusqu'à l'épuisement.	
$EN_NORMAL_LOWXP	<RE>$EN_NORMAL_NICK_NAME	<RE>$EN_NORMAL_FLAVOR_NAME	<RE>$EN_NORMAL_FLAVOR_TEXT	
$EN_CULTIST_LOWXP	<RE>$EN_CULTIST_NICK_NAME	<RE>$EN_CULTIST_FLAVOR_NAME	<RE>$EN_CULTIST_FLAVOR_TEXT	
$EN_ARMORED CULTIST_LOWXP	<RE>$EN_ARMORED CULTIST_NICK_NAME	<RE>$EN_ARMORED CULTIST_FLAVOR_NAME	<RE>$EN_ARMORED CULTIST_FLAVOR_TEXT	
$EN_NORMAL_W_LOWXP	<RE>$EN_NORMAL_NICK_NAME	<RE>$EN_NORMAL_W_FLAVOR_NAME	<RE>$EN_NORMAL_W_FLAVOR_TEXT	
$EN_ARMORED_LOWXP	<RE>$EN_ARMORED_NICK_NAME	<RE>$EN_ARMORED_FLAVOR_NAME	<RE>$EN_ARMORED_FLAVOR_TEXT	
$EN_SPEEDY_LOWXP	<RE>$EN_SPEEDY_NICK_NAME	<RE>$EN_SPEEDY_FLAVOR_NAME	<RE>$EN_SPEEDY_FLAVOR_TEXT	
$EN_SPEEDY_W_LOWXP	<RE>$EN_SPEEDY_NICK_NAME	<RE>$EN_SPEEDY_W_FLAVOR_NAME	<RE>$EN_SPEEDY_W_FLAVOR_TEXT	
$EN_ARMORED SPEEDY_LOWXP	<RE>$EN_SPEEDY_NICK_NAME	<RE>$EN_ARMORED SPEEDY_FLAVOR_NAME	<RE>$EN_ARMORED SPEEDY_FLAVOR_TEXT	
$EN_ARMORED_SPEEDY_W_LOWXP	<RE>$EN_SPEEDY_NICK_NAME	<RE>$EN_ARMORED_SPEEDY_W_FLAVOR_NAME	<RE>$EN_ARMORED_SPEEDY_W_FLAVOR_TEXT	
$EN_ATTACKER_LOWXP	<RE>$EN_ATTACKER_NICK_NAME	<RE>$EN_ATTACKER_FLAVOR_NAME	<RE>$EN_ATTACKER_FLAVOR_TEXT	
$EN_DARK ATTACKER_LOWXP	<RE>$EN_DARK ATTACKER_NICK_NAME	<RE>$EN_DARK ATTACKER_FLAVOR_NAME	<RE>$EN_DARK ATTACKER_FLAVOR_TEXT	
$EN_ATTACKER_W_LOWXP	<RE>$EN_ATTACKER_NICK_NAME	<RE>$EN_ATTACKER_W_FLAVOR_NAME	<RE>$EN_ATTACKER_W_FLAVOR_TEXT	
$EN_ARMORED ATTACKER_LOWXP	<RE>$EN_ATTACKER_NICK_NAME	<RE>$EN_ARMORED ATTACKER_FLAVOR_NAME	<RE>$EN_ARMORED ATTACKER_FLAVOR_TEXT	
$EN_RAPID_ATTACKER_LOWXP	<RE>$EN_RAPID_ATTACKER_NICK_NAME		
$EN_APC_LOWXP	<RE>$EN_APC_NICK_NAME	<RE>$EN_APC_FLAVOR_NAME	<RE>$EN_APC_FLAVOR_TEXT			
$EN_APC_W_LOWXP	<RE>$EN_APC_NICK_NAME	<RE>$EN_APC_W_FLAVOR_NAME	<RE>$EN_APC_W_FLAVOR_TEXT	
$EN_ARMORED APC_LOWXP	<RE>$EN_ARMORED APC_NICK_NAME	<RE>$EN_ARMORED APC_FLAVOR_NAME	<RE>$EN_ARMORED APC_FLAVOR_TEXT	
$EN_DOUBLE APC_LOWXP	<RE>$EN_DOUBLE APC_NICK_NAME	<RE>$EN_DOUBLE APC_FLAVOR_NAME	<RE>$EN_DOUBLE APC_FLAVOR_TEXT	
$EN_ARMORED RANGED ATTACKER_LOWXP	<RE>$EN_RANGED ATTACKER_NICK_NAME	<RE>$EN_ARMORED RANGED ATTACKER_FLAVOR_NAME	<RE>$EN_ARMORED RANGED ATTACKER_FLAVOR_TEXT	
$EN_RANGED ATTACKER_LOWXP	<RE>$EN_RANGED ATTACKER_NICK_NAME	<RE>$EN_RANGED ATTACKER_FLAVOR_NAME	<RE>$EN_RANGED ATTACKER_BASIC_FLAVOR_TEXT	
$EN_RANGED ATTACKER_W_LOWXP	<RE>$EN_RANGED ATTACKER_NICK_NAME	<RE>$EN_RANGED ATTACKER_W_FLAVOR_NAME	<RE>$EN_RANGED ATTACKER_W_FLAVOR_TEXT	
$EN_DARK_LOWXP	<RE>$EN_DARK_NICK_NAME	<RE>$EN_DARK_FLAVOR_NAME	<RE>$EN_DARK_FLAVOR_TEXT	
$EN_BRUTE_LOWXP	<RE>$EN_BRUTE_NICK_NAME	<RE>$EN_BRUTE_FLAVOR_NAME	<RE>$EN_BRUTE_FLAVOR_TEXT	
$EN_APC_NOATTACK_LOWXP	<RE>$EN_APC_NICK_NAME	<RE>$EN_APC_FLAVOR_NAME	<RE>$EN_APC_FLAVOR_TEXT			
$EN_CULTIST_NOATTACK_LOWXP	<RE>$EN_CULTIST_NICK_NAME	<RE>$EN_CULTIST_FLAVOR_NAME	<RE>$EN_CULTIST_FLAVOR_TEXT	
$EN_ERROR	ERREUR	Erreur	Je suis une erreur|Si vous lisez ceci, cela signifie que quelqu'un a fait une faute de frappe dans les données des ennemis. Nous affichons cet ennemi lorsque celui qui était prévu ne peut pas être trouvé.
$EN_SHEEP	MOUTON	Mouton	Délicieux Mammifère|Les Dragons peuvent rester des années sans manger, mais lorsqu'ils se nourrissent, ils peuvent engloutir plusieurs fois leur propre poids en une seule journée. Ce fait représente une source d'inconfort majeure pour les bergers nomades et pour leurs troupeaux.
$EN_PSI SHEEP	<RE>$EN_SHEEP_NICK_NAME	<RE>$EN_SHEEP_FLAVOR_NAME	<RE>$EN_SHEEP_FLAVOR_TEXT	
$EN_SPEEDY SHEEP	MOUTON RAPIDE	Mouton Rapide	Délicieux Mammifère Rapide|Certains moutons ont su s'adapter aux conditions hostiles de la Fosse en développant des muscles hautement spécialisés à contraction rapide. Ils ne leur sont pas très utiles pour échapper aux Dragons, mais ils leur permettent au moins de distancer les autres moutons.
$EN_SUPER SHEEP	SUPER MOUTON	Super Mouton	Délicieux Mammifère Mythique|Les légendes des Dragons parlent à mi-mots et sur un ton très révérencieux de ce mouton très rare, l'Axxima Vatta Muttanaxxor, et les écrits sacrés des Dragons détaillent un rituel élaboré qui devra être exécuté lors de son arrivée. Les penseurs traditionnels ont tendance à ranger les écrits des Dragons aux côtés des textes religieux, mais de récentes recherches tendraient à suggérer qu'il faudrait les reclasser en compagnie des livres de cuisine...
$EN_OZIMAL	OZIMAL	Ozimal Kaz	Revenant Esclave|Les sorciers tels que Zelemir sont réputés pour être capables de transformer directement des créatures vivantes en bonne santé, en esclaves non-morts.<N>Le sort nécessite une longue préparation, car le sorcier doit introduire un poison particulier dans la nourriture du sujet pendant plusieurs jours.<N>Cette pratique est une sorte « d'assurance », au cas où les acolytes du sorcier chercheraient à se retourner contre lui.
$EN_TWIN	JUMEAU	Jumeau	Frère Revenant|BLARGH YAAAARGH GAR GAR HUR.
$EN_3_11_BOSS	BOSS
$EN_RIGHT_INDEX_FINGER	INDEX	Index	Doigt Monstrueux|Bien que tranché de sa main, ce doigt se déplace par sa propre volonté.
$EN_RIGHT_THUMB	POUCE	Pouce	Pouce Monstrueux|Bien que tranché de sa main, ce pouce se déplace par sa propre volonté.
$EN_RIGHT_MIDDLE_FINGER	MAJEUR	Majeur	Doigt Monstrueux|Ce doigt tranché semble faire un geste obscène. Quelle grossièreté !
$EN_RIGHT_RING_FINGER	ANNULAIRE	Annulaire	<RE>$EN_RIGHT_INDEX_FINGER_FLAVOR_TEXT	
$EN_RIGHT_PINKY_FINGER	AURICULAIRE	Auriculaire	<RE>$EN_RIGHT_INDEX_FINGER_FLAVOR_TEXT	
$EN_RIGHT_EYE	L'OEIL D'EZTLI	L'Oeil d'Eztli	Oeil Monstrueux|Cet œil malveillant brille d'un pouvoir maléfique et se déplace avec une rapidité surnaturelle.
$EN_RIGHT_HAND	LA MAIN D'EZTLI	La Main d'Eztli	Main Monstrueuse|Le chef des Sanguinaires a appelé ce monstre <LQ>La Main Droite d'Eztli-Tenoch<RQ>. Compte tenu du peu de choses connues à propos d'Eztli-Tenoch, il n'est pas évident d'affirmer qu'il s'agit vraiment de la main du terrible magicien, ou si ce n'est qu'une création de sa magie noire. Et après examen, il semblerait plutôt qu'il s'agisse d'une main GAUCHE... C'est vraiment sinistre.	
$EN_FINGER	LE DOIGT D'EZTLI
$EN_ZELEMIR-CITADEL	<RE>$EN_ZELEMIR_NICK_NAME	<RE>$EN_ZELEMIR_FLAVOR_NAME	<RE>$EN_ZELEMIR_FLAVOR_TEXT	
$EN_ZELEMIR	ZELEMIR	Zelemir	Sorcier Nécromancien|Une détermination résolue brille dans le regard de Zelemir.
$EN_HEALIE	SOIN-SOIN	Soin-Soin	Boss Secret|Description
$EN_MEANIE	VILAIN	Vilain	Boss Secret|Description
$EN_STEALY	AIGREFIN	Aigrefin	Boss Secret|Description
$EN_CRAZY	ZINZIN	Zinzin	Boss Secret|Description
$EN_EZTLI	EZTLI-TENOCH	Eztli-Tenoch	Antique Magicien Légendaire|Une force antique, depuis longtemps en sommeil, et à présent éveillée. Eztli-Tenoch régnait autrefois sur le monde en tant que Roi-Dieu autoproclamé. Son pouvoir et sa malveillance n'ont d'égal que sa patience à toute épreuve.	
$END	
$EN_CULTIST_ACCOUNT			Ces récits ont été rapportés par les survivants du massacre de la tribu Geka. Il y est souvent fait mention de Sanguinaires se transformant en Revenants à volonté.
$EN_CULTIST_BASIC			<RE>[$EN_CULTIST_SECT_FLAVOR_TEXT]<N><N>On connaît peu de choses à propos de leur culte et de leurs croyances, en dehors du nom de leur divinité, <LQ>Eztli-Tenoch<RQ>, et de leur perpétuelle quête de nouvelles victimes.<N><N><RE>[$EN_CULTIST_ACCOUNT_FLAVOR_TEXT]
$EN_CULTIST_SECT			Le <LQ>Culte des Sanguinaires<RQ> n’était au départ qu’une secte de nomades connue pour ses cérémonies sanglantes.
$EN_RANGED ATTACKER_BASIC			Au fil des semaines, un étrange processus semble digérer et transformer le corps des Revenants.<N><N>Des témoins affirment avoir été attaqués par des <LQ>hommes-serpent<RQ> dépourvus d'yeux et crachant une bile nauséabonde.